OOOOOOOOOOOOOO
O###O.I.O#O.IO
O###O.I.O#O.IO
O###O.I.O#O.IO
OOOOO.I.OOO.IO
O.....I.....IO
O-----@-----?O
O.....I......O
OOOOO.I.OOOO.O
O###O.I.O###.O
O###O.I.O###.O
O###O.I.O###.O
OOOOOOOOOOOOOO