##FO.I.OS###FGGO.I.
##FO.I.OS###FGGO.I.
AA4O.I.O1AAA4GGO.I.
OOOO.I.OOOOOOOOO.I.
.....I...........I.
-----@-----------Y-
.....I.............
OOOO.I.OOOOOOOOOOOO
DD3O.I.O2DDDDDDDD3O
##FO.I.OS####b###FO
##FO.I.OS########FO