###O.I.O#####GGO.I.
###O.I.O#####GGO.I.
###O.I.O#####GGO.I.
OOOO.I.OOOOOOOOO.I.
.....I...........I.
-----@-----------Y-
.....I.............
OOOO.I.OOOOOOOOOOOO
###O.I.O##########O
###O.I.O##########O
###O.I.O##########O