OOOO.I.OOOOOOOOO.I.
AA4O.I.O22222222.I.
##FO.I.O22222222.I.
##FO.I.O11111111.I.
AA4O.I.O11111111.I.
AA4O.I.O33333333.I.
OOOO.I.OOOOOOOOO.I.
.....I..........oI.
-----@-----------Y-
.....I.............
OOOO.I.OOOOOOOOOOOO
DD3O.I.O2DDDDDDDD3O
##FO.I.OS####b###FO
##FO.I.OS########FO